################################
#                              #
#                              #
#                              #
#                              #
#                              #
#           #########          #
#           #       #          #
#           #       #          #
#           #########          #
#                              ##########
#                              #        #
#                              #        #
#                              #        #
#                                       #
#                                       #
#####        ############################