#####        #############################
#                   #                    #
#                   #                    #
#                                         
#                                         
#                                         
#                                         
#                   #                    #
#                   #                    #
###############    ##########            #
#                   #       #            #
#                   #                    #
#                   #       #            #
#                   #       ##############
#                   #                    #
#                   #                     
#                   #                    #
#                   #                    #
##########################################

