##########################           #####
#		    #                    #
#		    #                    #
#                                         
#                                         
#                                         
#                                         
#                   #                    #
#                   #                    #
#######     #################            #
#                   #       #            #
#                   #                    #
#                   #       #            #
#                   #       ##############
#                   #                    #
#                   #                     
#                   #                    #
#                   #                    #
##########################################

