################################################
#                                              #
#                                              #
                                               #
                                               #
                                               #
                                               #
#                                              #
#                                              #
#                                              #
#                                              #
#          ########  ###############    ########
############                #                  #
#          #                #                  #
#          #                #                  #
           #                #                  #
#          #                #                  #
#          #                #                  #
################################################